10.oax
..........
.........o
..........
....o....o
..........
..........
oo..ooo...
.........o
.....o.o..
.o........
