10.ox
........o.
a....o....
...o......
o....o....
..........
........o.
..........
.o....o...
o.........
.........o
