11
11111
11
12E9C38P01
1111111111