11111111111111111111
1P00000C000E00000001
11111111111111111111