1111111111111111
1PE0C0000000C001
1000C000M0000001
1000C00000000001
1000C00000000001
1111111111111111