11111111111111111111
100000000000000000P1
10000000000000000001
1E0000000000000000C1
11111111111111111111