11111111111111111111
1000000C000000000001
1000000C000000000001
1P00000C0000M0000E01
1000000C000000000001
11111111111111111111