1111111111111111
1P0M0C010000C001
1000C00100000001
1000C00000000001
100EC00100000001
1111111111111111